2 13 31
###############################
#p     ** *  *   2 *  * * *   #
# # # #*# # #*#*# # # #*#*#*# #
#   *     ***  *      * 2 * * #
# # *** # #*# # #*#*# # # # #*#
#f    1      **  *  *    *    #
# # # * * #     # #*# #*# # # #
#*         *  *      *        #
# # # # #*# # # #*#*# # # # # #
#*    #*  *       *    1      #
# #*# # # # # # #*# # # # # # #
#      x    *   *  *          #
###############################
