1 13 31
###############################
#p     *b *  1 * 2 *  * * *   #
# # # #*# # #*#*# # # #*#*#*# #
#   *     ***  *  1   * 2 * * #
# # # # # #s# # #*#*# # # # #*#
#f         x **  *  *   1     #
# # # # # # # # # #*# #*# # # #
#*  *      *  *      *        #
# # # # #*# # # #*#*# # # # # #
#*    **  *       *           #
# #*# # # # # # #*# # # # # # #
#           *   *  *          #
###############################
