1 13 31
###############################
#      ** *  1 *   *  * * *   #
# # # #*# # #*#*# # # #*#*#*# #
#p   *    ***  *  1   * 2 * * #
# # # # # #*# # #*#*# # # # #*#
#   x        **  *  *         #
# # # # # # # # # #*# #*# # # #
#*  *      *  *      *        #
# # # # #*# # # #*#*# # # # # #
#*    **           3          #
# #*# # # # # # #*# # # # # # #
#      4    *   *  *          #
###############################