1 13 31
###############################
#      ** *    * 2 *  * * *   #
# # # #*# # #*#*# # # #*#*#*# #
#p  *     ***  *      *   * * #
# # # # # #*# # #*#*# # # # #*#
#            **  *  * 34      #
# # # # # # # # # #*# #*# # # #
#*  *      *  * 1    *        #
# # # # #*# # # #*#*# # # # # #
#*  1* **  *       *          #
# #*# # # # # # #*# # # # # # #
#         x *   *  *          #
###############################
