1 13 31
###############################
#      ** *  1 *   *  * * *   #
# # # #*# # #*#*# # # #*#*#*# #
#p  x*    ***  *  1   * 2 * * #
# # # # # #*# # #*#*# # # # #*#
#f         x **  *  *         #
# # # # # # # # # #*# #*# # # #
#*  *      *  *      *        #
# # # # #*# # # #*#*# # # # # #
#*    **           3          #
# #*# # # # # # #*# # # # # # #
#      4    *   *  *          #
###############################