2 13 31
###############################
#      ** *    * 2 *  * * *   #
# # # #*# # #*#*# # # #*#*#*# #
#   * *   ***  *  1   *   * * #
# # # # # #*# # #*#*# # # # #*#
#   p *    x **  *  *   4     #
# # ###   # # # # #** #*# # # #
#*  *     **  *      *    5   #
# ### # #*# # # #*#*# * # # # #
#*    **  * *   2 *           #
# #*# * # # # # #*# # # # # # #
#  1        *3  *  *          #
###############################
